1111111111111111111111111111111111111111111111111111111111111111111111
0000000000130000000000000000000000000000000000000000000000000000000001
1011111110111111111111111111111111111111111111111111111111111111111101
1011111110100111100000000000000000000000000000000000000000000000000101
1010000000100000111101010111111010111111111010101011111111111111110101
1010101010111110111101010101130013100000000010101010000000000000000101
1010101010100003000001010101111111101111111110101010011111111111010101
1010101010101111111101010100000000100000000010101010000000000000010101
1010101010111111111101010111111110111111111010101010111111111111110101
1010101010100000000001010000000010100000000010101010000000000000000101
1010101010111111111101011111111010101111111110101010111111111111011101
1010101010100111100000000003000010100000000010101010111111100000013101
1010101010100000001111011111111110111111111010101010000011101111010101
1010101013111111000001000000000000130000000010101010111110101111010101
1010111011111101111011111111111110111011111110101010110010001111110101
1010100000000001000000010000000000131000000000101010111011100000010101
1010111111111101110101010111111111101111111111101011111011111111010101
1010100000000001010101010000000000100000000000001310000000000000000101
1010101111110101010101011111111110111111111111111111111111111110111101
1010100000310101010101000000000110000000000000000011100000000000000101
1010101111110101010101111111110111111111111111111011111111111111110101
1010100000110101010101000000010100000000001000000010000000100000000101
1010101010110101000101011111010101111111101011111111111110001111111101
1010101010110111111101000101010101000000101010000003000000100000000101
1010101010110000000101010101310101011110101010111111111111111111110001
1010111011110111111101010101010101030110101010000000000000000000001111
1010100000010000000101010001010101010000001010111111111101111011110001
1010111111011111110101011111010101011111111010310000001111111011110101
1000000000000000000001000000000001000000000011111111100000000000000102
1111111111111111111111111111111111111111111111111111111111111111111111



